111111111111111111111111111111111111111111
1010001111101110101000000000000CM110000011
101010111111101110000100000000110000000001
1000000P000000M00011111C011110000000000111
101110101110101011101100000000010000000001
1111111011000100010111000100000000C0011101
1000111000001010111011C1111101111000011111
101010101110000100101000C000000000M1110001
1110111010001000M000001111100000001C000011
1000C00C101010000000011100000C0000000000E1
111111111111111111111111111111111111111111
