11111111
1EE111C1
10000001
1P000001
11111111