1111111111
100EPC0001
1111111111
1CCCCCCCC1
1111111111