11111111111111
100MC010011001
110P0011111001
11100000000C01
100E000C00M101
11111111111111
